0|0|0|0|0|0|0|0|0|1|2|3
1|0|0|0|0|0|0|0|0|0|0|0
2|0|1|1|2|3|0|8|0|0|0|6
3|0|1|1|2|3|0|5|0|1|1|7
4|0|0|1|1|1|1|1|1|0|0|0
5|0|0|1|1|1|0|0|1|1|1|0
6|0|0|0|0|1|3|0|1|0|1|0
7|0|0|0|0|1|1|1|1|1|1|0
8|0|0|0|0|1|3|0|0|0|0|0
9|3|9|9|9|9|9|9|0|0|0|0
10|3|9|9|9|9|9|9|12|0|0|0
11|3|9|9|9|9|9|9|12|0|0|0