0|0|0|0|0|0|0|0|0|1|2|3
0|0|0|0|0|0|0|0|0|0|0|0
0|0|1|1|2|3|0|6|0|0|0|4
0|0|1|1|2|3|0|0|0|7|8|5
0|0|0|1|1|1|0|0|0|0|0|0
0|0|0|1|1|1|0|0|0|0|0|0
0|0|0|0|0|1|3|0|0|0|0|0
0|0|0|0|0|1|1|0|0|0|0|0
0|0|0|0|0|1|3|0|0|0|0|0
0|0|0|0|0|1|0|0|0|0|0|0
0|0|0|0|0|0|0|0|0|0|0|0
0|0|0|0|0|0|0|0|0|0|0|0