1|1|1|1|1|1|1|1|1|1|1|1
1|1|1|1|1|1|1|1|1|1|1|1
1|1|1|1|1|1|1|1|1|1|1|1
1|1|1|1|1|1|1|1|1|1|1|1
1|1|1|1|1|1|1|1|1|1|1|1
1|1|1|1|1|1|1|1|1|1|1|1
1|1|1|1|1|1|1|1|1|1|1|1
1|1|1|1|1|14:message=Allez à la forêt.|1|1|1|1|1|1
11|11|11|11|11|11|11|11|11|11|11|11
11|11|11|11|11|11|11|11|11|11|11|11
11|11|11|11|11|11|11|11|11|11|11|11
11|11|11|11|11|11|11|11|11|11|11|11
1|1|1|1|1|1|1|1|1|1|1|1
1|1|1|1|1|1|1|1|1|1|1|1
1;12|1|1|1|1|1|1|1|1|1|1|1
1|1;12|1|1|1|1|1|1|1|1;12|1|1
1|1|1|1|1|1|1|1|1|1|1|1
1|1|1|1|1|1|1|1|1|1|1|1
1|1|1|1|1|1|1|1|1|1;12|1|1
1|1|1;12|1|1|1|1|1|1|1|1|1
1|1|1|1|1|1|1|1|1|1|1|1
1|1|1|1;12;13|1;12;13|1;12;13|1;12;13|1|1|1|1|1
1|1|1|1|1|1|1|1|1|1|1|1
1|1|1|1|1|1|1|1|1|1|1|1
script: road.py