0|0|0|0|0|0|0|0|0|0|0|0
0|2|2|2|2|2|2|2|2|2|2|0
0|2|6|2|2|2|2|2|2|2|4|0
0|2|2|2|2|2|2|2|2|2|5|0
0|1|1|1|1|1|1|1|1|7|8|0
0|1|1|1|1|1|1|1|1|1|1|0
0|1|1|1|1|1|1|1|1|1|1|0
0|1|1|1|1|1|1|1|1|1|1|0
0|1|1|1|1|1|1|1|1|1|1|0
0|0|0|0|0|1|1|0|0|0|0|0