3|1|1|1|1|1|1|1|1|1|1|1|3|1|1|1|1|1|1|1|1|1|1|1
3|1|1|1|1|1|1|1|1|1|1|1|3|1|1|1|1|1|1|1|1|1|1|1
3|1|1|1|1|1|1|1|1|1|1|1|3|1|1|1|1|1|1|1|1|1|1|3
3|9;10|9;10|9;10|9;10|1|1|1|1|1|1|1|3|1|1|1|1|1|1|1|1|1|1|1
3|9;10|9;10|9;10|9;10|3|3|3|1|1|1|1|3|1|1|1|1|1|1|1|1|1|1|1
3|1|1|1|1|3|1|3|1|1|1|1|3|1|1|1|3|3|1|1|1|1|3|1
3|1|1|1|1|3|3|3|1|1|1|1|3|1|1|1|1|3|1|1|1|1|1|1
3|1|1|1|1|1|1|1|1|1|1|1|1|1|1|1|3|3|1|1|1|1|1|1
3|1|1|1|1|1|1|1|1|1|1|1|1|1|1|1|1|1|1|1|1|1|1|1
3|1|1|1|1|1|1|1|1|1|1|1|3|1|1|1|1|1|1|1|1|1|1|1
3|1|1|1|1|3|3|3|1|1|1|1|3|1|1|1|1|1|1|1|1|1|1|1
3|1|1|1|1|3|3|3|1|1;12;13|1;12;13|1;12;13|3|1|1|1|1|1|1|1|1|1|1|1
3|1|1|1|1|3|3|3|1|1;12;13|1;12;13|1;12;13|3|1|1|1|1|1|1|1|1|1|1|1
3|1|1|1|1|3|3|3|1|1|1|1|3|1|1|1|1|1|1|1|1|1|1|1
3|1|1|1|1|3|3|3|1|1|1|1|3|1|1|1|1|1|1|1|1|1|1|5:to=house