0|0|0|0|0|0|0|0|0|0|0|0
0|4|4|4|4|4|4|4|4|4|4|0
0|4|8|4|4|4|4|4|4|4|6|0
0|4|4|4|4|4|4|4|4|4|7|0
0|2|2|2|2|2|2|2|2|2|2|0
0|2|2|2|2|2|2|2|2|2|2|0
0|2|2|2|2|2|2|2|2|2|2|0
0|2|2|2|2|2|2|2|2|2|2|0
0|2|2|2|2|2|2|2|2|2|2|0
0|0|0|0|0|5:to=debug|5:to=debug|0|0|0|0|0